R   1000  1000

C 174,47,74

F 003,143,143


NO ./pics/wood.png

S ./pics/barrel.png


SO  ./pics/greystone.png

EA ./pics/bluestone.png

WE ./pics/redbrick.png

11111111111
1002000001 1111111
100200000012000201
120000001111111111
11110111111 11111111           
12000N0001  11      
100200000111021     
1001010000000001    
 100000011000001
 111111111111111    