R 2000 2500





C 00,47,74

F 003,143,100


SO ./pics/wood.xpm

S ./pics/barrel.xpm


NO  ./pics/greystone.xpm

EA ./pics/bluestone.xpm

WE ./pics/redbrick.xpm


                                111                                            11                   
                              110001                                         11001                  
                             10000001                                       100001                  
                            100000001                                       100001111 111           
                          11000000001                                        1100000010001          
                         1000000000001                                         10000000001          
                        10000000011001111                                      1000000001           
                        100000000011000001                                      100000001           
                         10000000001110001                                      100000001  11       
                      1110000020000110000011111                                 10000000111001      
                     100000000000000100000000001                                1000200000001   111 
                     100100000000000000000000000111                             10000000000001 10001
                     1001110000000001000000000001001                            10000002000001 10001
                     10010000000000000000000010000001                           11020000000001102001
                     100000000000000000000011100000001                         101000000000000000001
                      111001000000110000001  10000001                          100000000000000200001
                        100000000110000000011100000001                      111000000002000020000001
                         11111100000000000000000000001                1    1001100000000000000110101
                               11010000000000110000000111           1101 1 1001000000000000000000001
                                 101000000000011000000000111       100011011000000000000000000000001
                                 1000100000000010000000000001      100000010011001000000000000000001
                                  1000000100010000000000000011     10000001011 110000000000000000001
                                   1110000000100001000000000001    1000010002011100000000000000S0001
                                      1110011100100000000000001     11001000000000010000000000000001
                                         11100001111000000000011  11 1011000000000000000000000000001
                                           10001   100000000000011001001 110100000000000000000000001
                                            111111100000000000001100001   10010000200000000000000001
                                              100000010001011000000011     1010000000000000000000001
                                              1000000000011  11000001      1010000000000000000000001
                                              10000000011001   1100001 1 111000000000000000000000001
                                              100100000011011110000001101000000000000000000000000001
                                               10000000000000000011101100011000000000000000000000001
                                              10000000000000000001 100000100000000000000000010110001
                                              10000000000000000001  10000100001000000000001000011101
                                             11000001000000000001  1000000000000000000000000011  101
                                            1000000000000000000011111000000000000000000001101     1 
                                            1010000000000000000000001000000010000000002001001       
                                           10010000000000000000001100010000000000000000000001       
                                           1000000000000000000001  110000000000000000000000001      
                                            11101111000000011001 11000012001000000000000000001      
                                               1   100000001 11110000000000000000000000000101       
                                                  1000000001  1000000000000000000000000000101       
                                                   11111111    111111111111111111111111111 1        