R 2000 2500





C 00,47,74

F 003,143,100


NO ./pics/wood.xpm

S ./pics/barrel.xpm


SO  ./pics/greystone.xpm

EA ./pics/bluestone.xpm

WE ./pics/redbrick.xpm


11111111111111111111111111111
10000000001100000000000000001
10110000011100000200000010001
10010000000000000000000010201
10110000011100000000000010001
10000000001100000111011110001
11110111111111011100000010001
11110111111111011101010010001
11000000110101011100000010001
10000000000000001100000010001
10000200000002001101010010001
11000000110101011111011110N01
11110111111101011111011110001
11111111111111111111111111111